34
11
50 50 50 50 50 50 50 50 50 50 50 50 50 50 50 50 50 50 50 50 50 50 50 50 50 50 50 50 50 50 50 50 50 50 
50 0 0 0 0 0 0 0 0 0 0 0 0 0 0 0 0 0 0 0 0 0 0 0 0 0 0 0 0 0 0 0 0 50 
50 0 0 0 0 0 0 0 0 0 0 0 0 0 0 0 0 0 0 0 0 0 0 0 0 0 0 0 0 0 0 0 0 50 
50 0 0 0 0 0 0 0 0 0 0 0 0 0 0 0 0 0 0 0 0 0 0 0 0 0 0 0 0 0 0 0 0 50 
50 0 0 0 0 0 0 0 0 0 0 0 0 0 0 0 0 0 0 0 0 0 0 0 0 0 0 0 0 0 0 0 0 50 
50 0 0 0 0 0 0 0 0 0 0 0 0 0 0 0 0 0 0 0 0 0 0 0 0 0 0 0 0 0 0 0 0 50 
50 0 0 0 0 0 0 0 0 0 0 0 0 0 0 0 0 0 61 60 45 0 0 44 60 62 0 0 0 0 0 0 0 50 
50 0 0 0 0 0 0 0 61 62 0 0 0 0 0 0 0 0 50 50 71 71 71 71 50 50 62 46 0 0 0 0 0 50 
50 0 0 0 0 61 60 60 50 50 0 0 0 0 0 0 0 0 50 50 70 70 70 70 50 50 50 60 60 62 0 0 0 50 
50 60 60 60 60 50 50 50 50 50 0 0 0 0 0 0 0 0 50 50 65 65 65 65 50 50 50 50 50 50 60 60 60 50 
50 50 50 50 50 50 50 50 50 50 60 60 60 60 60 60 60 60 50 50 50 50 50 50 50 50 50 50 50 50 50 50 50 50 
