50
16
50 0 0 0 0 0 0 0 0 0 0 0 0 0 0 0 0 0 0 54 50 50 50 50 50 50 50 50 50 50 50 50 50 50 50 50 50 50 50 50 50 50 50 50 50 50 50 50 50 50 
50 0 0 0 0 0 0 0 0 0 0 0 0 0 0 0 0 0 0 0 54 50 50 50 50 50 50 50 50 50 50 55 0 0 0 0 0 0 0 0 0 0 0 0 0 0 0 0 0 50 
50 0 0 0 0 0 0 0 0 0 0 0 0 0 0 0 0 0 0 0 0 0 54 50 50 50 50 50 50 50 55 0 0 0 0 0 0 0 0 0 0 0 0 0 0 0 0 0 0 50 
50 0 0 0 0 0 0 0 0 0 0 0 0 0 0 0 0 0 0 0 0 0 0 50 0 0 0 0 0 0 0 0 0 0 0 0 0 0 0 0 0 0 1 0 0 0 0 0 0 50 
50 0 0 0 40 41 42 0 0 0 0 0 0 0 0 0 0 0 0 0 0 0 0 56 0 0 0 0 0 0 0 0 0 61 60 60 60 60 60 60 60 60 60 60 60 60 62 0 0 50 
50 0 0 0 0 0 0 0 0 0 0 0 0 46 0 0 0 0 2 0 0 0 0 0 0 0 63 0 0 0 0 0 61 50 50 50 50 50 50 50 50 50 50 50 50 50 55 0 0 50 
50 0 47 0 0 0 0 1 0 0 61 60 60 45 0 0 44 60 60 60 62 0 0 0 0 0 50 0 0 61 60 60 50 50 50 50 50 50 50 50 50 50 50 50 50 0 0 0 0 50 
50 60 60 60 60 60 60 60 60 60 50 50 50 71 71 71 71 50 50 50 50 60 60 60 60 60 50 60 60 50 50 50 50 50 50 50 50 50 50 50 50 50 50 50 50 0 0 0 0 50 
50 50 50 50 50 50 50 50 50 50 50 50 50 50 50 50 50 50 50 50 50 50 50 50 50 50 50 50 50 50 55 0 0 0 0 0 0 0 56 0 50 0 0 0 50 0 0 61 60 50 
50 0 0 0 0 0 0 0 0 0 0 0 0 0 0 0 0 0 0 0 0 0 0 0 0 0 0 0 0 0 0 0 0 0 0 0 0 0 0 0 56 0 0 0 50 0 0 0 0 50 
50 0 0 0 0 0 0 0 0 0 0 0 0 0 0 0 0 0 0 0 0 0 0 0 0 0 0 0 0 0 0 0 0 63 0 0 0 0 0 0 0 0 0 0 50 0 0 0 0 50 
50 0 0 0 0 0 0 0 0 0 0 0 0 40 41 42 0 0 0 0 0 0 0 0 0 0 0 0 0 0 0 0 0 50 0 0 0 0 64 0 0 0 0 0 50 60 62 0 0 50 
50 0 0 0 0 0 0 0 0 0 0 0 0 0 0 0 0 0 44 45 0 0 0 0 0 0 0 0 0 0 0 0 0 50 0 0 0 0 0 0 63 0 0 0 0 0 0 0 0 50 
50 0 0 0 0 0 0 0 43 0 0 0 0 0 0 0 0 0 0 0 0 0 48 49 0 0 44 60 60 60 62 0 0 50 0 0 0 0 0 0 50 0 0 0 0 0 0 0 0 50 
50 60 60 60 60 62 71 71 71 71 71 71 71 71 71 71 71 71 71 71 71 71 71 71 71 71 71 50 50 50 50 60 60 50 60 60 60 60 60 60 50 60 60 60 60 60 60 60 60 50 
50 50 50 50 50 50 50 50 50 50 50 50 50 50 50 50 50 50 50 50 50 50 50 50 50 50 50 50 50 50 50 50 50 50 50 50 50 50 50 50 50 50 50 50 50 50 50 50 50 50 
