37
32
50 0 0 0 0 0 0 0 0 0 0 0 0 0 50 50 50 50 50 50 50 50 50 50 50 50 50 50 50 50 50 50 50 50 50 50 50 
50 0 0 0 0 0 0 0 0 0 0 0 0 0 50 0 0 0 0 50 0 0 0 0 0 0 0 0 0 0 0 0 0 0 0 0 50 
50 0 0 0 0 0 0 0 0 0 0 0 0 0 50 0 0 0 0 50 0 0 0 0 0 0 0 0 0 0 0 0 0 0 0 0 50 
50 0 0 0 0 0 0 0 0 0 0 0 0 0 50 0 0 63 0 50 0 0 0 53 0 0 0 0 0 0 0 0 0 0 0 0 50 
50 0 0 0 0 0 0 0 0 0 0 0 0 0 50 0 0 50 0 50 42 0 0 50 0 0 0 0 0 0 0 0 63 0 0 0 50 
50 0 61 62 0 0 0 64 0 0 0 0 0 0 50 0 0 50 0 50 0 0 0 50 0 0 0 0 0 0 0 0 50 0 0 0 50 
50 0 54 55 0 0 0 0 0 0 0 43 0 0 50 45 0 50 0 50 0 0 0 50 0 0 0 0 0 0 0 0 50 0 0 0 50 
50 0 0 0 0 0 0 0 0 0 0 0 0 0 50 0 0 50 0 50 0 0 44 50 71 60 60 60 60 60 62 71 50 0 0 0 50 
50 0 0 0 0 0 0 0 0 0 0 0 0 0 50 0 0 50 0 50 0 0 0 54 50 50 50 50 50 50 50 50 50 0 0 0 50 
50 0 0 0 0 0 0 0 0 0 0 0 0 0 50 0 44 50 0 50 45 0 0 0 0 0 0 0 0 0 0 0 50 0 0 0 50 
50 0 0 0 0 0 0 0 0 0 0 63 0 0 50 0 0 50 0 50 0 0 0 0 0 0 0 0 0 0 0 0 50 0 0 0 50 
50 0 0 0 0 0 0 0 0 0 0 50 0 0 50 0 0 50 0 50 0 0 0 0 0 0 0 0 0 0 0 0 50 0 0 0 50 
50 0 0 0 0 0 0 0 0 0 0 50 0 0 56 42 0 50 0 56 41 42 0 0 0 0 0 0 0 0 0 0 50 0 0 0 50 
50 0 0 0 0 0 0 0 0 0 0 50 0 0 0 0 0 50 0 0 0 0 0 0 0 0 0 0 0 0 0 0 50 0 0 0 50 
50 0 0 0 0 0 0 0 0 0 0 50 0 0 0 0 44 50 0 0 0 0 0 0 43 0 0 0 0 0 0 0 50 0 0 0 50 
50 0 0 0 0 0 0 0 0 0 0 50 0 0 0 0 0 50 0 0 43 0 0 0 0 0 0 0 0 0 0 0 50 0 0 0 50 
50 71 71 71 71 71 71 71 71 71 71 50 71 71 53 71 71 50 71 71 71 71 71 71 71 71 71 71 71 71 71 71 50 0 0 0 50 
50 50 50 50 50 50 50 50 50 50 50 50 50 50 50 50 50 50 50 50 50 50 50 50 50 50 50 50 50 50 50 50 50 0 0 0 50 
50 50 50 50 50 50 50 50 50 50 50 50 50 50 50 50 50 50 50 50 50 50 50 50 50 50 50 50 50 50 50 50 50 0 0 0 50 
50 50 50 50 50 50 50 50 50 50 50 50 50 50 50 50 50 50 50 50 50 50 50 50 50 50 50 50 50 50 50 50 50 0 0 0 50 
50 0 0 0 0 0 0 0 0 0 0 0 0 0 50 0 0 0 0 0 0 0 0 0 0 0 0 0 0 0 0 0 50 0 0 0 50 
50 0 0 0 0 0 0 0 0 0 0 0 0 0 50 0 0 0 0 0 0 0 0 0 0 0 0 0 0 0 0 0 50 0 0 0 50 
50 0 0 0 0 0 0 0 0 0 0 0 0 0 50 0 0 0 0 0 0 0 0 0 0 0 0 0 0 0 0 0 50 0 0 0 50 
50 0 0 0 0 0 0 0 0 0 0 43 0 0 50 0 0 0 0 0 0 0 0 0 0 0 0 0 0 0 0 0 50 0 0 0 50 
50 0 0 0 0 0 0 0 0 0 0 0 0 0 56 0 0 0 0 0 44 71 71 71 71 71 71 45 0 0 43 0 50 0 0 0 50 
50 0 0 0 0 0 0 0 0 0 0 0 0 0 0 0 0 0 0 0 0 54 50 50 50 50 55 0 0 0 0 0 50 0 0 0 50 
50 0 0 0 0 0 0 0 0 0 0 0 0 0 0 0 0 0 0 0 0 0 0 0 0 0 0 0 0 0 0 0 50 0 0 0 50 
50 0 0 0 0 0 0 0 0 0 0 43 0 0 0 0 0 0 0 0 43 0 0 0 0 0 0 0 0 0 43 0 56 0 0 0 50 
50 0 0 0 0 0 0 0 0 0 0 0 0 0 0 0 0 0 0 0 0 0 0 0 0 0 0 0 0 0 0 0 0 0 0 0 50 
50 45 0 0 0 0 0 0 0 0 0 0 0 0 0 0 0 0 0 0 0 0 0 0 0 0 0 0 0 0 0 0 0 0 0 0 50 
50 71 71 71 71 71 71 71 71 71 71 71 71 71 71 71 71 71 71 71 71 71 71 71 71 71 71 71 71 71 47 0 63 71 71 71 50 
50 65 65 65 65 65 65 65 65 65 65 65 65 65 65 65 65 65 65 65 65 65 65 65 65 65 65 65 65 65 51 50 50 50 50 50 50 
