12
47
50 0 0 0 0 0 0 0 0 0 0 50 
50 0 0 0 0 0 0 0 0 0 0 50 
50 0 0 0 0 0 0 0 0 0 0 50 
50 0 0 0 0 0 0 0 0 0 0 50 
50 0 0 0 0 0 0 0 0 0 0 50 
50 0 0 40 42 0 0 0 0 0 0 50 
50 0 0 0 0 0 0 0 0 0 0 50 
50 0 0 0 0 0 0 0 0 44 60 50 
50 0 0 0 0 0 0 0 0 0 0 50 
50 0 0 0 0 0 0 0 0 0 0 50 
50 60 60 45 0 0 0 0 0 0 0 50 
50 0 0 0 0 0 0 0 0 0 0 50 
50 0 0 0 0 0 0 0 0 0 0 50 
50 0 0 0 63 71 71 71 71 71 71 50 
50 0 0 0 54 50 50 50 50 50 50 50 
50 0 0 0 0 0 0 0 0 0 0 50 
50 0 0 0 0 0 0 0 0 0 0 50 
50 0 0 0 0 0 0 0 0 0 0 50 
50 71 71 71 71 71 63 0 0 0 0 50 
50 50 50 50 50 50 50 0 0 0 0 50 
50 0 0 0 0 0 0 0 0 0 0 50 
50 0 0 0 0 0 0 0 0 0 0 50 
50 0 0 0 0 0 0 0 0 0 0 50 
50 0 0 0 0 0 0 0 0 0 0 50 
50 0 63 0 0 0 0 0 0 0 0 50 
50 0 54 60 60 60 60 60 60 60 60 50 
50 0 0 56 0 0 0 0 0 0 0 50 
50 0 0 0 0 0 0 0 0 0 0 50 
50 0 0 0 0 0 63 0 0 63 0 50 
50 60 60 60 60 60 50 60 60 55 0 50 
50 0 0 0 0 0 0 0 0 0 0 50 
50 0 0 0 0 0 0 0 0 0 0 50 
50 0 0 63 0 0 46 0 47 0 0 50 
50 0 44 50 60 60 62 71 61 60 60 50 
50 0 0 54 50 50 50 50 50 50 50 50 
50 45 0 0 0 0 0 0 0 0 0 50 
50 0 0 0 0 0 0 0 0 0 0 50 
50 0 0 0 46 0 0 46 0 0 0 50 
50 0 0 0 40 41 41 42 0 0 0 50 
50 0 0 0 0 0 0 0 0 0 0 50 
50 49 0 0 0 0 0 0 0 0 43 50 
50 0 0 0 0 0 0 0 0 0 0 50 
50 0 0 0 0 0 43 0 0 0 0 50 
50 0 0 0 0 0 0 0 0 0 0 50 
50 0 0 0 0 0 0 0 0 0 0 50 
50 71 71 71 71 71 71 71 71 71 71 50 
50 65 65 65 65 65 65 65 65 65 65 50 
